111111
10C1E1
101001
1000P1
111111
